 #########
 #   #   #
 # @ #   #
##$**$**$#
#  #. .# ##
#  .*$*.  #
#         #
###########
Title: Two rooms
Collection: 100 Boxes
Author: François Marques