#######
#  +  #
##$#  #
#  #. #
#  $  #
#     #
#######
Title : ciroban 4
Collection: Ciroban
Author: nico
Best-steps:42