#######
#  @  #
##$#$ #
# * . #
#  ## #
# .   #
#######
Title : ciroban 3
Collection: Ciroban
Author: nico
Best-steps:44