#######
#     #
#$$#  #
#. +. #
# $## #
#     #
#######
Title : ciroban 5
Collection: Ciroban
Author: nico
Best-steps:33