#######
# @ . #
#   $ #
# ## ##
# # $ #
# .   #
#######
Title : ciroban 6
Collection: Ciroban
Author: nico
