#######
#     #
##$ # #
# +  .#
# $## #
# .$  #
#######
Title : ciroban 2
Collection: Ciroban
Author: nico
Best-steps:32