#######
#  @  #
##    #
# *$. #
#  #  #
# $.  #
#######
Title : ciroban 1
Collection: Ciroban
Author: nico
Best-steps:10
