#########
#  @ #  #
## #  $ #
# *#    #
#  ##$$##
# . #   #
# .     #
# . #   #
#########
Title : ciroban 0909-1
Collection: Ciroban
Author: nico