  #######
###    @#
# $ # # #
# #...$ #
#   #$# #
###     #
  #######
Title : Church 1
Collection: Ciroban
Author: nico