#######
# .   #
#  $..#
###$*###
# $@   #
#      #
########
Title: For ban 18
Collection: Novoban
Author: François Marques
AuthorMail: Francois.Marques@freesbee.fr
AuthorPage: http://sokoban.online.fr/
Date: 2001/03
Best-steps:81