####
#  #
#  #
# @###
# $$ #
#.  .#
######
Title: Be ban 7
Collection: Novoban
Author: François Marques
AuthorMail: Francois.Marques@freesbee.fr
AuthorPage: http://sokoban.online.fr/
Date: 2001/04
Best-steps:36
