####
#  ###
# @  #
#. #$##
##.$  #
# $.# #
# #   #
#    ##
###  #
  ####
Title: Try ban 1
Collection: Novoban
Author: François Marques
AuthorMail: Francois.Marques@freesbee.fr
AuthorPage: http://sokoban.online.fr/
Date: 2001/03
Best-steps:83