  ####
  #  ###
### .  #
#@$$$  #
#   #. #
###.  ##
  #####
Title: Try ban 23
Collection: Novoban
Author: François Marques
AuthorMail: Francois.Marques@freesbee.fr
AuthorPage: http://sokoban.online.fr/
Date: 2001/05
Best-steps:65