 ########
 #  ## .#
##   $  #
#  $#$ .#
#   #@ ##
#. ##  #
########
Title: Try ban 4
Collection: Novoban
Author: François Marques
AuthorMail: Francois.Marques@freesbee.fr
AuthorPage: http://sokoban.online.fr/
Date: 2001/02
Best-steps:106