####
#  ####
# .   #
# @$$ #
##  ###
 #. #
 #  #
 ####
Title: Be ban 14
Collection: Novoban
Author: François Marques
AuthorMail: Francois.Marques@freesbee.fr
AuthorPage: http://sokoban.online.fr/
Date: 2001/07
Best-steps:30