####
#  #####
#  .*. #
# $ $ @#
#   ####
#####
Title: Try ban 17
Collection: Novoban
Author: François Marques
AuthorMail: Francois.Marques@freesbee.fr
AuthorPage: http://sokoban.online.fr/
Date: 2001/04
Best-steps:49