                #######
       ###### ###     #
     ###    # #  $$##.#
 #####  $ $ ### #$ ##.#
 # $ $   #      #    .#
## # # $ #  ### #  ## #
# $  $   #### #  ##   #
# $#.*##$ #   ##    ###
#.*..... .#    ######
#  .#######
## @#
 #  #
 ####
Title : SasquatchV-L19
Collection : Sasquatch V
Author : David Skinner
