  ####
###  ##
#  $  #
#@.*. #
## $  #
 ###  #
   ####
Title: Try ban 13
Collection: Sokolate
Author: François Marques
Best-steps:62