#####
#   ##
# #  #
# $..##
##$.. #
# @$$ #
#   ###
#####
Title: ForBoxes 31
Collection: Sokolate
Author: François Marques
Best-steps:97