  ####
  #@ #
 ##$$#
 #   ##
##.#. #
# * * ##
#      #
####   #
   #####
Title: L'ai-je bien descendu ?
Collection: Sokolate
Author: François Marques
Best-steps:119