  ####
###  #
#  $@##
# # $ #
# $ # #
## ...#
 #   ##
 #####
Title: Try ban 12
Collection: Sokolate
Author: François Marques
Best-steps:81