 ####
 # .####
 #    .#
 #$$$$@#
## # ###
#   . #
# .   #
#######
Title: For ban 40
Collection: Sokolate
Author: François Marques
Best-steps:107