#####
#   ##
#    ###
##   $ #
##*#$#+##
# .  $. #
#   #   #
#########
Title: Three doors
Collection: Sokolate
Author: François Marques
Best-steps:113