    #####
 ####   #
 #  #   #
## * * ##
# *.*$@#
#  * * #
##     #
 #######
Title: Hepta ban 8
Collection: Sokolate
Author: François Marques
Best-steps:95