 #####
## . ##
#  *  #
# $$$ #
# .*. #
## @ ##
 #####
Title: Penta ban 3
Collection: Sokolate
Author: François Marques
Best-steps:44