 #####
 #   ####
##.#$#  #
#   $   #
# **.*  #
##  @  ##
 #######
Title: Penta ban 17
Collection: Sokolate
Author: François Marques
Best-steps:119