 #######
 #  .  #
## #.# #
# $$@$ #
#   . ##
#######
Title: Try ban 2
Collection: Sokolate
Author: François Marques
Best-steps:65