 #####
##   ###
# ..$$ #
#   $@ #
##.# ###
 #   #
 #####
Title: Try ban YZ 
Collection: Sokolate
Author: François Marques
Best-steps:82