 ####
 #  ####
##  .  #
#  $.$ ##
# $*#*@ #
## .$.  #
 #  #####
 #  #
 ####
Title: Hexa ban 17 
Collection: Sokolate
Author: François Marques
Best-steps:92
Difficulty:hard