 ####
 #  ####
## . $ #
#  * # #
#  $ . #
###*#@##
  #   #
  #####
Title: For ban 43
Collection: Sokolate
Author: François Marques
Best-steps:53