  ####
  #@ #
###$$###
#      #
# $#  .#
##.   ##
 ### .#
   ####
Title: Try ban ZY
Collection: Sokolate
Author: François Marques
Best-steps:108