    ####
#####  #
#   $  #
# @*** #
# # . ##
#   ###
#####
Title: For ban 36
Collection: Sokolate
Author: François Marques
Best-steps:94