  #####
 ##   #
 # $  #
 #.*$##
## * #
#  . #
#  @ #
######
Title: For ban 14
Collection: Sokolate
Author: François Marques
Best-steps:73