 ####
 #  #
##.$###
# . $ #
# .$#@#
# . $ #
#   ###
#####
Title: ForBoxes 25
Collection: Sokolate
Author: François Marques
Best-steps:85