   ####
####  #
# $   ##
#  *.. #
#  *$. #
##$.*$ #
 # @ ###
 #####
Title: Hepta ban 9
Collection: Sokolate
Author: François Marques
Best-steps:94