 #####
 #   #
##.#$###
#   $  #
# **.*@##
##      #
 ####   #
    #####
Title: Penta ban 18
Collection: Sokolate
Author: François Marques
Best-steps:132