#######
#  .  ##
#  *#$ ##
##@.$   #
 # *#$  #
 # .  ###
 #  ###
 ####
Title: Penta ban 15
Collection: Sokolate
Author: François Marques
Best-steps:162