 ####
##  ###
#   @ #
#  $# ###
## *. . #
 # **$  #
 #   ####
 #####
Title: L
Collection: Sokolate
Author: François Marques
Best-steps:108