#####
# @ #
#$$$##
# $  #
#  # #
#....#
#    #
######
Title: Level 6
Collection: Sokolate
Author: François Marques
Best-steps:112