#####
#   ###
#     #
##  # ###
 # $**  #
 ##@.*  #
  #  ####
  #  #
  ####
Title: ForBoxes 22
Collection: Sokolate
Author: François Marques
Best-steps:133