 #######
##   . #
#    $ #
# #$#*##
#  $ $ #
###@.. #
  # .###
  ####
Title: Penta ban 5
Collection: Sokolate
Author: François Marques
Best-steps:125