###########
#  $. .$  #
#  $*@*$  #
### .#. ###
  #     #
  #######
Title: T
Collection: Sokolate
Author: François Marques
Best-steps:114