  ####
  #  #
### .###
#  $$  #
# #+.# #
#  $$  #
###. ###
  #  #
  #  #
  ####
Title: The crucifix
Collection: Sokolate
Author: François Marques
Best-steps:47