 #######
 #  #  #
##  #  ##
# . @ . #
# #*#*# #
#   $   #
### $####
  #  #
  ####
Title: Split
Collection: Sokolate
Author: François Marques
Best-steps:101