 ####
 #  ###
 # *$ #
 # .# #
## *  #
#  *@ #
#   ###
#####
Title: For ban 12
Collection: Sokolate
Author: François Marques
Best-steps:80