#################
#   #  #     #  #
#@     #     #  #
###$#  ## #  #  ###
#   # ### #    #  #
# ##      #### #  #
#  #   ##  #      #
## ######  #   # ##
#  ##   #  ####   #
# ##    ####  #   #
# ##  ##   #  # ###
#  .#      #      #
## ## ### ### #   #
#      #  ### #####
#  #   #          #
#  #####  #####   #
####   ####   #####
Title: The run
Collection: Soloban
Author: François Marques
AuthorMail: Francois.Marques@freesbee.fr
AuthorPage: http://sokoban.online.fr/
Best-steps:1316